000000000000000
000000000000000
000001111100000
000001111100000
000001111100000
000001111100000
000000000000000
111110000000000
000010000000000
000000000000000
111110000000000
111110000000000
111110000000000
000000000000000
000000000010000